2,3,3,2,2,2,2,2
1,3,3,0,2,2,2,2
1,2,2,1,2,2,2,2
0,2,2,1,2,2,2,2
2,2,2,2,2,2,2,2
2,2,2,2,2,2,2,2
2,2,2,2,2,2,2,2
2,2,2,2,2,2,2,2